22333444455555555544
23333444455555545544
23333444455555555544
33334445555556555444
34444555555556555444
34444555555555555443
34444555555455555433
34444555555445555444
34444555555455555544
34444445555555555544
33344445555555555444
34444545555555555555
34444545555555555555
34444555565555445555
34344455656554444555
34444555656555555666
34334445555554545555
44333445655444444555
44433444554444444444
44443444454444444444