43444444555455555444
33333333334455555444
44556655544555665666
78788777656656666777
77666666777666656554
55555545676766666666
66766777766667766655
66555444444544544566
66666656553333444444
54545544443344333444
44555544444555666555
45556666777877876765
66666667777766666677
66665566556665555667
67666666666666666677
76677666556655544454
55444455676666666655
33344444445555554443
33333334444444444444
55556666655555666677


